00000000000000000000000000000000000000000000000000000000000000000000000000000000000000000000000000000000000000000000000000000000000000000000
00000000000000000000000000000000000000000000000000000000000000000000000000000000075555555555555555555555555555555590000000000000000000000000
00000000000000000000000000000000000000000000000000000000000000000000000000000000050000000000000000000000000000000050000000000000000000000000
00000000000000000000000000000000000000000000000000000000000000000000000000000000050000000000000000000000000000000050000000000000000000000000
00000000000000000000000000000000000000000000000000000000000000000000000000000000050000000000000000000000000000000050000000000000000000000000
00000000000000000000000000000000000000000000000000000000000000000000000000000000050000000000000000000000000000000050000000000000000000000000
000000000000000000000000000000000000000000000000000007555555555555555555555555555D0000000000000000000000000000000050000000000000000000000000
00000000000000000000000000000000000000000000000000000500000000000000000000000000050000045W55555555555555555556000050000000000000000000000000
00000000000000000000000000000000000000000000000000000500000000000000000000000000050000000500000000000000000000000050000000000000000000000000
00000000000000000000000000000000000000000000000000000500000000000000000000000000050000000500000000000000000000000050000000000000000000000000
00000000000000000000000000000000000000000000000000000500000000000000000000000000050000000500000000000000000000000050000000000000000000000000
0755555555555555555W55555W555555555555555555555555555300000000000000000000000000020000000500000000000000000000000050000000000000000000000000
05000000000000000005000005000000000000000000000000000000000000000000000000000000000000000500000000000000000000000050000000000000000000000000
05000000000000000005000005000000000000000000000000000000000000000000000000000000000000000A555555555555555555555555S5555590000000000000000000
05000000000000000005000002000000000000000000000000000000000000000000000000000000000000000500000000000000000000000000000050000000000000000000
05000000000000000005000000000000000000000000000000000000000000000000000000000000000000000500000000000000000000000000000050000000000000000000
05000000000000000005000000000000000000000000000000000000000000000000000000000000000000000500000000000000000000000000000050000000000000000000
05000007555590000005000000000000000000000000000000000000000000000000000000000000000000000500000000000000000000000000000050000000000000000000
05000005000050000005000008000000000000000000000000000000000000000000000000000000000000000500000000000000000000000000000050000000000000000000
05000005000050000005000005000000000000000000000000000000000000000000000000000000000000000500000455555555555555555559000050000000000000000000
05000005000050000005000005000000007555555555555555555900000000000000000000000000080000000500000000000000000000000005000050000000000000000000
050000050000500000050000050000000050000000000000000005000000000000000000000000000500000005000000000000000000000000050000A5555555555590000000
05000005000050000005000005000000005000000000000000000500000000000000000000000000050000000500000000000000000000000005000050000000000050000000
05000005000020000005000005000000005000000000000000000500000000000000000000000000050000000500000000000000000000000005000050000000000050000000
05000005000000000005000005000000005000000000000000000500000000000000000000000000050000045S55555555555555555556000005000050000000000050000000
050000050000000000050000050000000050000000000000000001555555555555555W55555W55555D0000000000000000000000000000000005000050000000000050000000
0500000500000000000500000500000000A555555555555900000000000000000000050000050000050000000000000000000000000000000005000050000008000050000000
05000005000000000005000005000000005000000000000500000000000000000000050000050000050000000000000000000000000000000005000050000005000050000000
05000001555555555553000005000000005000000000000500000000000000000000050000050000050000000000000000000000000000000005000050000005000050000000
05000000000000000000000005000000005000000000000500000000000000000000050000050000050000000000000000000000000000000005000050000005000015559000
05000000000000000000000005000000005000000000000500000000000000000000050000050000050000000000000000000000000000000005000050000005000000005000
0500000000000000000000000500000000500000000000015555555555555555900005000005000001555555555555555555555555555555555D000050000005000000005000
05000000000000000000000005000000005000000000000000000000000000005000050000050000000000000000000000000000000000000005000050000005000000005000
0155555555555555555555555D000000005000000000000000000000000000005000020000050000000000000000000000000000000000000005000050000005000000005000
00000000000000000000000005000000005000000000000000000000000000005000000000050000000000000000000000000000000000000005000050000005000000005000
00000000000000000000000005000000005000000000000000000000000000005000000000050000000000000000000000000000000000000005000050000001559000005000
00000000000000000000000005000000005000000000000755555555559000005000000000050000000000000000000000000000000000000005000050000000005000005000
00000000000000000000000005000000005000000000000500000000005000005000000000050000000000000000000000000000000000000005000050000000005000005000
00000000000000000000000005000000005000000000000500000000005000001555590000050000000000000000000000000000000000000005000050000000005000005000
00000000000000000000000005000000005000000000000500000000005000000000050000050000000000000000000000000000000000000005000050000000005000005000
00000000000000000000000005000000005000000000000500000000005000000000050000050000000000000000000000000000000000000005000050000000005000005000
0000000000000000000000000500000000500000000000050000800000500000000005000005000000075555555555W55555555555555555555300001555550000155555D000
00075555555590000000000005000000005000000000000500005000005000000000050000050000000500000000005000000000000000000000000000000000000000005000
00050000000050000000000005000000005000000000000500005000005000000000050000050000000500000000005000000000000000000000000000000000000000005000
00050000000050000000000005000000005000000000000500005000005000000000050000050000000500000000005000000000000000000000000000000000000000005000
00050000000015555555555553000000001555555555555300005000005555555000050000050000000500000000005000000000000000000000000000000000000000005000
0005000000000000000000000000000000000000000000000000500000000000000005000005000000050000000000A55555555555555555555900007555555555555555D000
00050000000000000000000000000000000000000000000000005000000000000000050000050000000500000000005000000000000000000005000050000000000000005000
00050000000000000000000000000000000000000000000000005000000000000000050000050000000500000000005000000000000000000005000050000000000000005000
00050000000000000000000000000000000000000000000000005000000000000000050000050000000500000000005000000000000000000005000050000000000000005000
000500000000755555555555590000000075555555555590000015555555555555555D0000050000000155555W5555D000000000000000000005000050000000000000005000
00050000000050000000000005000000005000000000005000000000000000000000050000050000000000000500005000000000000000000005000050000000000000005000
00050000000050000000000005000000005000000000005000000000000000000000050000050000000000000500005000000000000008000005000050000007555600005000
075S55555555D0000000000005000000005000000000005000000000000000000000050000050000000000000500001555555555600005000005000050000005000000005000
05000000000050000000000005000000005000000000005000000000000000000000050000050000000000000500000000000000000005000005000050000005000000005000
05000000000050000000000005000000005000000000005000000000000000000000050000050000000000000500000000000000000005000005000050000005000000005000
05000000000050000008000005000000005000008000005000007555555555555555530000015555555900000500000000000000000005000005000050000005000000005000
05000000000050000005000005000000005000005000005000005000000000000000000000000000000500000500000000000000000005000005000050000005000000005000
0500000800005000000500000500000000500000500000500000500000000000000000000000000000050000050000455555555560000200000200005000000A555600005000
05000005000050000005000005000000005000005000005000005000000000000000000000000000000500000500000000000000000000000000000050000005000000005000
05000005000050000005000005000000005000005000005000005000000000000000000000000000000500000500000000000000000000000000000050000005000000005000
05000005000050000005000005000000005000005000005000005000000000000000000000000000000500000500000000000000000000000000000050000005000000005000
05000005000050000005000005000000005000005000005000005000000000000000000000000000000500000500000000000005000000000000000050000005000000005000
05000005000050000005000005000000005000005000005000002000000755555600004555559000000500000500000000000005000000000000000050000005000000005000
0155555D00005000000500000500000000500000500000500000000000050000000000000000500000050000050000000000000500000000000000005000000A555600005000
00000005000050000005000005000000005000005000005000000000000500000000000000005000000500000500000000000005000000000000000050000005000000005000
00000005000050000005000005000000005000005000005000000000000500000000000000005000000500000500000000000005000000000000000050000005000000005000
00000005000050000005000005000000005000005000005000000000000500000000000000005000000500000500000000000005000000000000000050000005000000005000
00000005000050000005000005000000005000005000005000000000000500000000000000005000000500000500000000000005000000000000000050000005000000005000
0000000500005000000500000200000000200000500000155555555555530000000000000000155555530000015555555555555D000000000000000050000005000000005000
0000000500000000000500000000000000000000500000000000000000000000000000000000000000000000000000000000000500000000000000005000000A555600005000
00000005000000000005000000000000000000005000000000000000000000000000000000000000000000000000000000000005000000000000000050000005000000005000
00000005000000000005000000000000000000005000000000000000000000000000000000000000000000000000000000000005000000000000000050000005000000005000
00000005000000000005000000000000000000005000000000000000000000000000000000000000000000000000000000000005000000000000000050000005000000005000
0000000500000000000500000000000000755555S555555555555900000800000000000000008000007555555555555556000005000000000000000050000005000000005000
0755555300004555555S55555600000000500000000000000000050000050000000000000000500000500000000000000000000A5555W5555559000050000005000000005000
0500000000000000000000000000000000500000000000000000050000050000000000000000500000500000000000000000000500005000000500005000000A555600005000
05000000000000000000000000000000005000000000000000000500000500000000000000005000005000000000000000000005000050000005000050000005000000005000
05000000000000000000000000000000005000000000000000000500000500000000000000005000005000000000000000000005000050000005000050000005000000005000
05000000000000000000000000000000005000000000000000000500000500000000000000005000005000000000000000000005000050000005000050000005000000005000
05000000000000000000000000000000005000007555559000000500000155555900007555553000001555555555555559000005000050000005000050000005000000005000
05000000000000000000000000000000005000005000005000000500000000000500005000000000000000000000000005000005000050000002000020000005000000005000
0500000000000000000000000000000000500000500000500000050000000000050000500000000000000000000000000500000500005000000000000000000A555600005000
05000000000000000000000000000000005000005000005000000500000000000500005000000000000000000000000005000005000050000000000000000005000000005000
05000000000000000000000000000000005000005000005000000500000000000500005000000000000000000000000005000005000050000000000000000005000000005000
0A55559000004555555555555555555555D000005000005000000500000000000500005000000000000000000000000005000005000050000000000000000005000000005000
05000050000000000000000000000000005000005000005000000155555900000500005000000000000000000000000005000005000050000000000000000005000000005000
050000500000000000000000000000000050000050000050000000000005000005000050000045555555555555900000050000050000A5555555555555555553000000005000
05000050000000000000000000000000005000005000005000000000000500000500005000000000000000000050000005000005000050000000000000000000000000005000
0500005000000000000000000000000000500000500000500000000000050000050000500000000000000000005000000500000500005000000000000000000000000755S590
05000050000000000000000000000000005000005000005000000000000500000500005000000000000000000050000005000005000050000000000000000000000005000050
05000015555555555600004555559000005000005000005000000000000500000500005000000000000000000050000005000005000050000000000000000000000005000050
0500000000000000000000000000500000500000500000500000000000050000050000500000755555559000005000000500000500005000007555555555555555555D000050
05000000000000000000000000005000005000005000001555559000000200000500005000005000000050000015555553000005000050000050000000000000000005000050
05000000000000000000000000005000005000005000000000005000000000000500005000005000000050000000000000000005000050000050000000000000000005000050
05000000000000000000000000005000005000005000000000005000000000000500005000005000000050000000000000000005000050000050000000000000000005000050
01555555555555555900008000005000005000005000000000005000000000000500005000005000000050000000000000000005000050000050000000000000000005000050
00000000000000000500005000005000005000005000000000005000000000000500005000005000000050000000000000000005000050000050000000000000000005000050
000000000000000005000050000050000050000050000000000050000000000005000050000050000000A5555555555555555553000050000050000000000000000005000050
00000000000000000500005000002000005000001555555600001W55555555555300001555553000000050000000000000000000000050000050000000000000000002000050
00000000000000000500005000000000005000000000000000000500000000000000000000000000000050000000000000000000000050000050000000000000000000000050
00000000000000000500005000000000005000000000000000000500000000000000000000000000000050000000000000000000000050000050000000000000000000000050
00000000000000000500005000000000005000000000000000000500000000000000000000000000000050000000000000000000000050000050000000000000000000000050
00000000000000000500005000000000005000000000000000000500000000000000000000000000000050000000000000000000000050000050000000000000000000000050
0000000000000000050000500000000000500000000000000000050000000000000000000000000000005000004555555555555W5555D0000050000000000000000008000050
00000000000000000500001555555W5555S555555555555555555300004555555555555555559000000050000000000000000005000050000050000000000000000005000050
00000000000000000500000000000500000000000000000000000000000000000000000000005000000050000000000000000005000050000050000000000000000005000050
00000000000000000500000000000500000000000000000000000000000000000000000000005000000050000000000000000005000050000050000000000000000005000050
00000000000000000500000000000500000000000000000000000000000000000000000000005000000050000000000000000005000050000050000000000000000005000050
00000000000000000500000000000500000000000000000000000000000000000000000000005000000050000000000000000005000050000050000000000000000005000050
000000000000000005000008000005000008000045555555555555555555555555590000455530000000A5555555555556000005000050000050000000000000000005000050
00000000000000000500000500000200000500000000000000000000000000000005000000000000000050000000000000000002000020000015555555555555555553000050
00000000000000000500000500000000000500000000000000000000000000000005000000000000000050000000000000000000000000000000000000000000000000000050
00000000000000000500000500000000000500000000000000000000000000000005000000000000000050000000000000000000000000000000000000000000000000000050
00000000000000000500000500000000000500000000000000000000000000000005000000000000000050000000000000000000000000000000000000000000000000000050
00000000000000000500000500000000000500000000000000000000000000000005000000000000000050000000000000000000000000000000000000000000000000000050
00000000000000000155555S55555555555S5555555555555555555555555555555S5555555555555555S5555555555555555555555555555555555555555555555555555530
00000000000000000000000000000000000000000000000000000000000000000000000000000000000000000000000000000000000000000000000000000000000000000000